________
___P_P__
__P_PP_P
__P_P___
______P_
____W_P_
__P_____
______GP
