__________
____PW____
_____G__P_
__P___P_P_
____PP____
_____P____
____P____P
__________
_P______P_
_________P
